....................############R.....
....................#.................
................#######...............
................#...#.#...............
................#...#.#...............
................#...#.#...............
................#.#####...............
................#.#.#.................
..........#############...............
..........#.....#.#.#.#...............
..........#.....#.#.#.#...............
..........#.....#.#.#.#...............
..........#.....#####.#...............
..........#.......#...#...............
#####.....#.......#...#############...
#...#.....#.......#...............#...
#...#.....#.......#...............#...
#...#.....#.......#...............#...
#...#.....#.......#############...#...
#.........#...................#...#...
###########...................#...#...
..............................#...#...
........................#######...#...
........................#.........#...
......................###########.#...
......................#.#.......#.#...
......................#.#...#######...
......................#.#...#...#.....
......................#############...
........................#...#...#.#...
........................#...#####.#...
........................#.........#...
........................#.........#...
........................#.........#...
........................#############.
..................................#.#.
..................................#.#.
..................................#.#.
..................................#.#.
..................................#.#.
..............................#####.#.
..............................#.....#.
..............................#.....#.
..............................#.....#.
..............................#######.
......................................
......................................